border_size=1
usage=map

Xu          , Rp          , Uu^Ii       , Xu          , Xu          , Xu          , Xu          , Xu          , Xu          , Xu          , Xu          , Xu          , Xu          , Xu          , Xu          , Xu          , Xu          , Xu          , Xu          , Xu          , Xu          , Xu          , Uu^Ii       , Rp          , Uu^Ii       , Uu^Ii       
Xu          , Rp          , Uu^Ii       , Xu          , Xu          , Xu          , Xu          , Xu          , Xu          , Xu          , Xu          , Xu          , Xu          , Xu          , Xu          , Xu          , Xu          , Xu          , Xu          , Xu          , Xu          , Xu          , Uu^Ii       , Rp          , Uu^Ii       , Xu          
Xu          , Rp          , Uu^Ii       , Xu          , Xu          , Xu          , Xu          , Xu          , Xu          , Uu^Ii       , Uu^Ii       , Uu^Ii       , Uu^Ii       , Uu^Ii       , Xu          , Xu          , Xu          , Xu          , Xu          , Xu          , Xu          , Xu          , Uu^Vud      , Rp          , Uu^Ii       , Xu          
Xu          , Rp          , Rp          , Uu^Ii       , Xu          , Xu          , Xu          , Xu          , Xu          , Uu^Ii       , Uu^Ii       , Uu^Ii       , Uu^Ii       , Uu^Ii       , Xu          , Xu          , Xu          , Xu          , Xu          , Xu          , Uu^Ii       , Uu^Ii       , Rp          , Rp          , Uu^Vud      , Xu          
Xu          , Uu^Vud      , Rp          , Uu^Ii       , Xu          , Xu          , Xu          , Xu          , Xu          , Uu^Ii       , Xu          , Uu^Ii       , Xu          , Uu^Ii       , Xu          , Xu          , Xu          , Xu          , Uu^Ii       , Uu^Ii       , Rp          , Rp          , Uu^Ii       , Uu^Ii       , Xu          , Xu          
Xu          , Xu          , Rp          , Uu^Ii       , Xu          , Xu          , Xu          , Xu          , Xu          , Xu          , Uu^Ii       , Uu^Ii       , Uu^Ii       , Xu          , Xu          , Xu          , Xu          , Xu          , Uu^Ii       , Rp          , Uu^Ii       , Uu^Ii       , Uu^Ii       , Xu          , Xu          , Xu          
Xu          , Xu          , Rp          , Uu^Ii       , Uu^Ii       , Xu          , Uu^Ii       , Xu          , Uu^Ii       , Uu^Ii       , Cud         , Uu^Ii       , Cud         , Uu^Ii       , Uu^Ii       , Xu          , Xu          , Uu^Ii       , Uu^Vud      , Rp          , Uu^Vud      , Uu^Ii       , Xu          , Xu          , Xu          , Xu          
Xu          , Xu          , Rp          , Uu^Vud      , Rp          , Uu^Ii       , Uu^Vud      , Uu^Ii       , Cud         , Cud         , Uu^Ii       , Uu^Ii       , Uu^Ii       , Cud         , Cud         , Uu^Ii       , Uu^Ii       , Uu^Ii       , Rp          , Rp          , Uu^Ii       , Uu^Ii       , Xu          , Xu          , Xu          , Xu          
Xu          , Xu          , Xu          , Rp          , Uu^Vud      , Rp          , Rp          , Cud         , Uu^Ii       , Uu^Vud      , Cud         , Cud         , Cud         , Uu^Vud      , Uu^Ii       , Cud         , Rp          , Rp          , Uu^Vud      , Uu^Ii       , Xu          , Xu          , Xu          , Xu          , Xu          , Xu          
Xu          , Xu          , Xu          , Xu          , Xu          , Xu          , Xu          , Rp          , Cud         , Cud         , Cud         , Cud         , Cud         , Cud         , Cud         , Rp          , Cud         , Uu^Ii       , Uu^Ii       , Uu^Ii       , Xu          , Xu          , Xu          , Xu          , Xu          , Xu          
Xu          , Xu          , Xu          , Xu          , Xu          , Xu          , Xu          , Xu          , Cud         , Cud         , Cud       , Cud         , Cud         , Cud         , Cud         , Uu^Ii       , Cud         , Uu^Ii       , Xu          , Xu          , Xu          , Xu          , Xu          , Xu          , Xu          , Xu          
Xu          , Xu          , Xu          , Xu          , Xu          , Xu          , Xu          , Xu          , Cud         , Cud         , Cud         , 1 Kud         , Cud         , Cud         , Cud         , Uu^Ii       , Cud         , Uu^Ii       , Xu          , Xu          , Xu          , Xu          , Xu          , Xu          , Xu          , Xu          
Xu          , Xu          , Xu          , Xu          , Xu          , Xu          , Xu          , Xu          , Cud         , Cud         , Cud         , Cud         , Cud         , Cud         , Cud         , Uu^Ii       , Cud         , Uu^Vud      , Xu          , Xu          , Xu          , Xu          , Xu          , Xu          , Xu          , Xu          
Xu          , Xu          , Xu          , Xu          , Xu          , Xu          , Rp          , Rp          , Uu^Ii       , Cud         , Cud         , Cud         , Cud         , Cud         , Uu          , Rp          , Rp          , Uu^Ii       , Uu^Ii       , Xu          , Xu          , Xu          , Xu          , Xu          , Xu          , Xu          
Xu          , Xu          , Uu^Vud      , Xu          , Rp          , Rp          , Uu^Ii       , Cud         , Cud         , Uu^Vud      , Uu^Ii       , Cud         , Uu^Ii       , Uu^Vud      , Cud         , Cud         , Uu^Ii       , Rp          , Rp          , Uu^Ii       , Xu          , Xu          , Xu          , Xu          , Xu          , Xu          
Uh          , Uh          , Uu^Ii       , Rp          , Uh          , Uu^Vud      , Uu^Ii       , Uu^Ii       , Uu^Ii       , Cud         , Cud         , Uu^Ii       , Cud         , Cud         , Uu^Ii       , Uu^Ii       , Uu^Vud      , Uu^Ii       , Rp          , Uu^Ii       , Uu^Ii       , Xu          , Xu          , Xu          , Xu          , Xu          
Uu^Ii       , Uu^Ii       , Rp          , Rp          , Uu^Ii       , Uu^Ii       , Xu          , Uu^Ii       , Uu^Ii       , Uu^Ii       , Uu^Ii       , Uu^Ii       , Uu^Ii       , Uu^Ii       , Uu^Ii       , Uu^Ii       , Xu          , Uu^Ii       , Rp          , Uu^Vud      , Uu^Ii       , Xu          , Xu          , Xu          , Xu          , Xu          
Uu^Ii       , Uu^Vud      , Rp          , Uu^Vud      , Uh          , Xu          , Xu          , Xu          , Xu          , Uu^Ii       , Xu          , Uu^Ii       , Uu^Ii       , Uu^Vud      , Xu          , Xu          , Xu          , Uu^Ii       , Uu^Vud      , Rp          , Uu^Ii       , Uu^Ii       , Xu          , Xu          , Xu          , Xu          
Rp          , Rp          , Uu^Vud      , Uu^Ii       , Xu          , Xu          , Xu          , Xu          , Xu          , Xu          , Xu          , Xu          , Xu          , Xu          , Xu          , Xu          , Xu          , Uu^Ii       , Uu^Ii       , Rp          , Rp          , Uu^Ii       , Uu^Ii       , Xu          , Xu          , Xu          
Uu          , Uu^Ii       , Uu^Ii       , Uu^Ii       , Xu          , Xu          , Xu          , Xu          , Xu          , Xu          , Xu          , Xu          , Xu          , Xu          , Xu          , Xu          , Xu          , Xu          , Uu^Ii       , Uu^Ii       , Rp          , Uu^Ii       , Uu^Ii       , Uu^Ii       , Xu          , Xu          
