border_size=1
usage=map

Uu          , Uu          , Rr          , Uu          , Xu          , Xu          , Xu          , Xu          , Xu          , Xu          , Xu          , Xu          , Xu          , Xu          , Xu          , Xu          , Xu          , Xu          , Xu          , Xu          , Xu          , Xu          , Xu          , Uu          , Rr          , Xu          
Xu          , Uu          , Rr          , Uu          , Xu          , Xu          , Xu          , Xu          , Xu          , Xu          , Xu          , Xu          , Xu          , Xu          , Xu          , Xu          , Xu          , Xu          , Xu          , Xu          , Xu          , Xu          , Xu          , Uu^Vud      , Rr          , Xu          
Xu          , Uu          , Rr          , Uu^Vud      , Xu          , Xu          , Xu          , Xu          , Xu          , Xu          , Xu          , Xu          , Xu          , Xu          , Xu          , Xu          , Xu          , Xu          , Xu          , Xu          , Xu          , Xu          , Xu          , Uu          , Rr          , Xu          
Xu          , Uu^Vud      , Rr          , Rr          , Rr          , Uu          , Xu          , Xu          , Xu          , Xu          , Xu          , Xu          , Xu          , Xu          , Xu          , Xu          , Xu          , Xu          , Xu          , Xu          , Xu          , Xu          , Uu          , Rr          , Rr          , Xu          
Xu          , Xu          , Uu          , Rr          , Rr          , Rr          , Rr          , Uu          , Xu          , Xu          , Xu          , Xu          , Xu          , Xu          , Xu          , Xu          , Xu          , Xu          , Xu          , Xu          , Xu          , Xu          , Uu          , Rr          , Uu^Vud      , Xu          
Xu          , Xu          , Xu          , Uu^Vud      , Uu          , Rr          , Rr          , Uu          , Xu          , Xu          , Xu          , Xu          , Xu          , Xu          , Xu          , Xu          , Xu          , Xu          , Xu          , Xu          , Xu          , Xu          , Uu^Vud      , Rr          , Xu          , Xu          
Xu          , Xu          , Xu          , Xu          , Uu          , Uu^Vud      , Rr          , Uu^Vud      , Uu          , Xu          , Xu          , Uu          , Uu          , Uu^Vud      , Uu          , Uu^Vud      , Uu          , Uu          , Xu          , Uu          , Xu          , Uu          , Rr          , Rr          , Xu          , Xu          
Xu          , Xu          , Xu          , Xu          , Uu          , Uu          , Rr          , Rr          , Rr          , Uu^Vud      , Uu          , Cud         , Cud         , Uu          , Uu          , Uu          , Cud         , Cud         , Uu          , Uu^Vud      , Rr          , Rr          , Rr          , Rr          , Xu          , Xu          
Xu          , Xu          , Xu          , Xu          , Xu          , Xu          , Uu^Vud      , Rr          , Rr          , Rr          , Cud         , Uu^Vud      , Uu^Vud      , Cud         , Cud         , Cud         , Uu^Vud      , Uu^Vud      , Cud         , Rr          , Rr          , Rr          , Uu^Vud      , Xu          , Xu          , Xu          
Xu          , Xu          , Xu          , Xu          , Xu          , Xu          , Uu          , Rr          , Rr          , Cud         , Cud         , Cud         , Cud         , Cud         , Cud         , Cud         , Cud         , Cud         , Rr          , Xu          , Xu          , Xu          , Xu          , Xu          , Xu          , Xu          
Xu          , Xu          , Xu          , Xu          , Xu          , Xu          , Xu          , Rr          , Rr          , Cud         , Cud         , Cud         , Cud         , Cud         , Cud         , Cud         , Cud         , Cud         , Xu          , Xu          , Xu          , Xu          , Xu          , Xu          , Xu          , Xu          
Xu          , Xu          , Xu          , Xu          , Xu          , Xu          , Xu          , Rr          , Rr          , Cud         , 1 Kud       , Cud         , Cud         , Cud         , Cud         , Cud         , 2 Kud       , Cud         , Xu          , Xu          , Xu          , Xu          , Xu          , Xu          , Xu          , Xu          
Xu          , Xu          , Xu          , Xu          , Xu          , Xu          , Xu          , Rr          , Rr          , Cud         , Cud         , Cud         , Cud         , Cud         , Cud         , Cud         , Cud         , Cud         , Xu          , Xu          , Xu          , Xu          , Xu          , Xu          , Xu          , Xu          
Xu          , Xu          , Xu          , Xu          , Xu          , Xu          , Xu          , Rr          , Rr          , Cud         , Cud         , Cud         , Cud         , Cud         , Cud         , Cud         , Cud         , Uu          , Rr          , Rr          , Xu          , Xu          , Xu          , Xu          , Xu          , Xu          
Xu          , Xu          , Xu          , Xu          , Xu          , Xu          , Uu          , Rr          , Rr          , Cud         , Cud         , Cud         , Uu^Vud      , Uu^Vud      , Cud         , Uu^Vud      , Uu^Vud      , Cud         , Cud         , Rr          , Rr          , Uu^Vud      , Xu          , Uu^Vud      , Xu          , Xu          
Xu          , Xu          , Xu          , Xu          , Xu          , Uu          , Uu^Vud      , Rr          , Rr          , Uu^Vud      , Uu          , Uu          , Cud         , Cud         , Uu          , Cud         , Cud         , Uu          , Uu          , Uu          , Uu^Vud      , Rr          , Rr          , Uu          , Uu          , Uu          
Xu          , Xu          , Xu          , Xu          , Xu          , Uu          , Rr          , Rr          , Uu          , Xu          , Uu          , Uu          , Uu          , Uu          , Uu          , Uu          , Uu          , Uu          , Uu          , Xu          , Uu          , Uu          , Rr          , Rr          , Uu^Vud      , Uu^Vud      
Xu          , Xu          , Xu          , Xu          , Uu          , Rr          , Rr          , Rr          , Uu          , Xu          , Xu          , Xu          , Uu^Vud      , Uu          , Uu^Vud      , Xu          , Uu^Vud      , Xu          , Xu          , Xu          , Xu          , Uu          , Uu^Vud      , Rr          , Rr          , Uu          
Xu          , Xu          , Xu          , Uu^Vud      , Rr          , Rr          , Rr          , Uu^Vud      , Uu          , Xu          , Xu          , Xu          , Xu          , Xu          , Xu          , Xu          , Xu          , Xu          , Xu          , Xu          , Xu          , Xu          , Uu          , Rr          , Rr          , Rr          
Xu          , Xu          , Uu          , Uu          , Rr          , Rr          , Uu          , Uu          , Xu          , Xu          , Xu          , Xu          , Xu          , Xu          , Xu          , Xu          , Xu          , Xu          , Xu          , Xu          , Xu          , Xu          , Uu          , Uu          , Uu          , Uu          
